1  1  1  1  1  1  1  1  1  1  1  1  1  1
1  0  0  0  0  0  0  0  0  0  0  0  0  1
1  0  0  0  0  1  2  3  4  5  6  7  8  1
1  0  0  0  0  0  0  0  0  0  0  0  0  1
1  0  0  0  0  0  0  0  0  0  0  0  0  1
1  0  0  0  0  0  0  0  0  0  0  0  0  1
1  0  0  0  0  0  0  0  0  0  0  0  0  1
1  0  0  0  0  0  0  0  0  0  0  0  0  1
1  0  22 0  24 0  23 0  20 0  24 0  0  1
1  0  0  0  0  0  0  0  0  0  0  0  0  1
1  0  0  0  0  0  0  0  0  0  0  0  0  1
1  0  0  0  0  0  0  0  0  0  0  0  0  1
1  0  0  0  0  0  0  0  0  0  0  0  0  1
1  0  0  0  0  0  x  0  0  0  0  0  0  1
1  1  1  1  1  1  1  1  1  1  0  1  1  1
