37 32 37 37 37 37 37 37 37 37 37 37 37 37 37 37 37 37 32 37
37 x  36 31 31 0  0  0  0  0  0  0  0  0  0  37 0  37 0  37
37 0  36 0  0  0  34 34 34 0  34 34 0  31 0  0  0  37 0  37
37 0  36 0  31 31 34 0  0  0  34 31 0  31 37 37 37 37 0  37
37 0  36 0  31 0  31 34 34 34 34 31 0  31 0  0  0  0  0  37
37 0  36 0  31 0  31 31 31 31 31 31 0  31 0  33 33 33 33 37
37 0  36 0  31 0  0  0  0  0  0  0  0  31 0  0  0  0  0  37
37 0  36 0  31 0  0  31 31 0  31 31 31 31 0  36 30 0 30  37
37 0  0  0  31 31 0  31 33 0  33 31 31 31 0  36 30 0 30  37
37 31 31 0  31 31 0  31 33 0  0  0  0  0  0  36 30 0 30  37
30 0  0  0  31 31 0  31 33 0  33 31 31 31 0  36 0  0  0  37
37 31 31 31 30 0  0  31 33 0  0  0  33 0  0  36 30 30 0  37
37 37 37 37 37 37 37 37 37 33 33 33 33 36 36 37 37 37 37 37
