37 37 37 37 37 37 37 37 37 37 37 37 37 37 37 37 37 37 37 37
37 x  36 30 30 0  0  0  0  0  0  0  0  0  0  0  0  0  0 37
37 0  36 0  0  0  30 30 34 0  34 0  0  0  0  0  0  0  0 37
37 0  36 0  30 30 30 0  0  0  34  0  0  0  0  0  0  0  0 37
37 0  36 0  30 0  30 34 34 34 34  0  0  0  0  0  0  0  0 37
37 0  36 0  30 0  0  0  0  0  0  0  0  0  0  0  0  0  0 37
37 0  36 0  30 0  0  0  0  0  0  0  0  0  0  0  0  0  0 37
37 0  36 0  30 0  0  0  0  0  0  0  0  0  0  0  0  0  0 37
37 0  0  0  32 0  0  0  0  0  0  0  0  0  0  0  0  0  0 37
37 30 30 0  30 0  0  0  0  0  0  0  0  0  0  0  0  0  0 37
37 0  0  0  30 0  0  0  0  0  0  0  0  0  0  0  0  0  0 37
37 30 30 30 30 0  0  0  0  0  0  0  0  0  0  0  0  0  0 37
37 37 37 37 37 37 37 37 37 37 37 37 37 37 37 37 37 37 37 37
