37 37 37 37 37 37 37 37 37 37 37 37 37 37 37
37 0 0 0 0 0 0 0 0 0 0 0 0 0 33
37 0 0 0 0 0 0 0 0 0 0 0 0 0 33
37 0 0 0 3 0 0 0 0 0 0 2 0 0 33
37 0 0 0 0 0 0 0 0 0 0 0 0 0 33
37 0 0 0 0 0 0 0 0 0 0 0 0 0 33
37 0 0 x 0 0 0 0 0 0 0 0 0 0 33
37 0 0 0 0 0 0 0 0 0 0 0 0 0 33
37 0 0 0 0 0 0 30 0 0 0 0 0 0 33
37 0 0 0 0 0 0 0 0 0 0 0 0 0 33
37 0 0 0 0 0 0 0 0 0 0 32 0 0 33
37 0 0 0 0 0 0 0 0 0 0 0 0 0 33
37 34 34 34 34 34 34 34 34 34 34 34 34 34 33
